18,43.
1,2.
X X X X X X X X X X X X X X X X X X X X X X/
X                 X             D X   X   X/
X X X X X X   X       X X X X X X X D X   X/
              X X X X X               X   X/
X X X X   X           X X X X   X X P X   X/
X         X X X X X X X           X   X   X/
X   X X   X D X           X X X   X X X   X/
X     X   X   X   X X X X X   X   D       X/
X   X X   X   X   X   X               X X X/
X D X         X       X   X X   X X   X T X/
X X X   X X X X   X   X   X       X   X   X/
X       X         X   X   X X X   X X X   X/
X   X   X     X X X   X   X   X           X/
X   X         X   X X X   X   X X X X X X X/
X   X   X X X X   D           X   X P X   X/
X   X   X         X   X X X   X       X   X/
X   X       X     X     X         X        /
X X X X X X X X X X X X X X X X X X X X X X/